NO ./textures/pengxpms/peng1.xpm
SO ./textures/pengxpms/peng2.xpm
WE ./textures/pengxpms/xpeng2.xpm
EA ./textures/pengxpms/xpeng3.xpm

F 50,86,9   
C 50,168,139


                    111111111111111111111111 1111111111111
                    11111111111111111111111111111111111111
                    10000001000001011100001001000000100001
                    10010110010100100010010100110100100111
                    11001010100101011001010100101001000111
                    10000001010111010000000100101010001001
                    11011111111111111111111111111111111111
                     111
   1111
            11111111111111111111111111111111111111
            10000000011110010010101001001000011111
            10000000000111010010100100101010100011
            10001010100101001010100010010101001001
11111111111111111111111111111111111111000000000001
10000000000000000000000000000000000000011111111111
100000000000000000000S0000000000000000000111111111
101111111111111111111011111111111110111111     
101                 100001        101         
101                 100001        101     
101                 100001        101
101                 100001        101
101                 100001        101
101                 100001        101
101                 100001        101
101                 100001        101
101                 100001        101
101                 100001        101
101                 100001        101
101                 100001        101
101                 100001        101
101111111111111111111111011111111110111111111
1000000000000000000000000000000000000000001
11111111111111111111111111111110111111111111
111111111111111111111111111111111111111
