            11111111111111111111111111111111111111
11111111111111111111111111111111111111000000000W01
10000000000000000000000000000000000000001111111111
10111111111111111111101111111111111011111
101                 100001        101
101                 100001        101
101                 100001        101
101                 100001        101
101                 100001        101
101                 100001        101
101                 100001        101
101                 100001        101
101                 100001        101
101                 100001        101
101                 100001        101
101                 100001        101
101                 100001        101
101111111111111111111111011111111110111111111
1000000000000000000000000000000000000000001
11111111111111111111111111111111111111111111

WE ./textures/wall1.xpm
NO ./textures/wall4.xpm
SO ./textures/wall2.xpm

EA ./textures/wall3.xpm


F 50,86,168
C 50,168,139
